type octile
height 41
width 45
map
TTTTTTTTTTTTTTTTTTTTTTTTTTTTTTTTTTTTTTTTTTTTT
T.......................T..................ST
TTTTT...TTTTT...TTTTTTTTT...TTTTT...TTTTTTTTT
T.......T...T...T...........T...T...........T
T...TTTTT...T.......TTTTT...T...TTTTTTTTT...T
T.......T.......T...T...................T...T
T...T.......TTTTT...TTTTT...T...TTTTT...T...T
T...T.......T...T.......T...T...T.......T...T
TTTTT...T...T...TTTTT...TTTTT...T...TTTTTTTTT
T.......T.......T.......T.......T...........T
T...T...TTT...TTT...TTTTT...TTTTTTTTT...TTTTT
T...T...T.......T...T...........T...........T
T...TTTTT...T...T...TTTTTTTTT...TTTTT...T...T
T...T.......T.......T.......T.......T...T...T
T...T...TTTTTTTTT...T...T...TTTTT...........T
T...T...T...............T...................T
T...T...TTTTTTTTTTTTT...TTTTTTTTTTTTT...T...T
T.......T...............T...T...........T...T
T...TTTTT...TTTTTTTTT...T...T...TTTTTTTTT...T
T...T.......T...........T...T...T.......T...T
T...T...T...T...TTTTT...T...T...T...T...T...T
T.......T...T.......T...T...........T...T...T
T...TTTTT...TTTTT...T...TTTTT...TTTTT...T...T
T...T...............T...........T...T.......T
TTTTT...TTTTTTTTT...TTTTTTTTT...T...TTTTT...T
T...T...T.......T...........T...T.......T...T
T...T.......TTTTT...TTTTT...T...TTTTT...T...T
T...T...............T.......T...............T
T...T...T...TTTTTTTTT...TTTTTTTTT.......TTTTT
T...T...T...T...........T...........T.......T
T...T...T...T.......TTTTT...TTTTTTTTTTTTT...T
T.......T...T...T...........T...............T
TTTTTTTTT...T...TTTTT...TTTTTTTTT...T...TTTTT
T.......T.......T...............T...T.......T
T...T...TTTTT...TTTTTTTTT...T.......TTTTT...T
T...T.......T...............T...........T...T
T...T...TTTTTTTTT.......TTTTT...T...TTTTT...T
T...T...........T...T...T.......T...T.......T
T...TTTTT...TTTTT...T...T...TTTTTTTTT...TTTTT
T.......T...............T...................T
TTTTTTTTTTTTTTTTTTTTTTTTTTTTTTTTTTTTTTTTTTTTT