type octile
height 11
width 16
map
TTTTTTTTTTTTTTTT
T..............T
T..............T
T..............T
T..............T
T..............T
T..............T
T..............T
T..............T
T..............T
TTTTTTTTTTTTTTTT