type octile
height 38
width 105
map
TTTTTTTTTTTTTTTTTTTTTTTTTTTTTTTTTTTTTTTTTTTTTTTTTTTTTTTTTTTTTTTTTTTTTTTTTTTTTTTTTTTTTTTTTTTTTTTTTTTTTTTTT
T...T.......................T...................T...............................................T.......T
T...T.......................T...................T...............................................T.......T
T...T.......................T...................T...............................................T.......T
T...T...TTTTTTTTTTTTTTTTT...T...TTTTTTTTT...T...TTTTTTTTT...TTTTTTTTTTTTTTTTTTTTTTTTTTTTTTTTT...T...T...T
T...T.......T...T...........T...T...........T...............T.......T...................T...T...T...T...T
T...T.......T...T...........T...T...........T...............T.......T...................T...T...T...T...T
T...T.......T...T...........T...T...........T...............T.......T...................T...T...T...T...T
T...TTTTT...T...T...TTTTTTTTT...T...TTTTTTTTTTTTTTTTTTTTT...T...TTTTT...TTTTTTTTT...T...T...T...T...T...T
T...........T...T...............T...T...........T.......T...............T...........T.......T...T...T...T
T...........T...T...............T...T...........T.......T...............T...........T.......T...T...T...T
TTTTTTTTTTTTT...TTTTTTTTTTTTT...T...T...TTTTT...T...T...TTTTT...TTTTTTTTT...TTTTTTTTTTTTT...T...TTTTT...T
T...............T...............T...........T.......T.......T.......T.......T.......T.......T.......T...T
T...............T...............T...........T.......T.......T.......T.......T.......T.......T.......T...T
T...............T...............T...........T.......T.......T.......T.......T.......T.......T.......T...T
T...TTTTTTTTTTTTT...TTTTTTTTTTTTTTTTTTTTTTTTTTTTTTTTTTTTT...TTTTTTTTT...TTTTT...TTTTT...TTTTTTTTT...T...T
T...................T.......T...............T...............T...........T.......T.......T...........T...T
T...................T.......T...............T...............T...........T.......T.......T...........T...T
T...................T.......T...............T...............T...........T.......T.......T...........T...T
T...TTTTTTTTTTTTTTTTT...T...T...T...TTTTT...T...TTTTTTTTTTTTT...TTTTTTTTT...TTTTT...TTTTT...TTTTTTTTT...T
T...............T.......T...T...T...T.......T...T.......T.......T...........T...........T...T.......T...T
T...............T.......T...T...T...T.......T...T.......T.......T...........T...........T...T.......T...T
T...............T.......T...T...T...T.......T...T.......T.......T...........T...........T...T.......T...T
TTTTTTTTTTTTT...TTTTT...T...T...T...T...TTTTT...T...TTTTT...T...TTTTTTTTT...T...TTTTTTTTT...T...T...T...T
T...T.......T...........T...T...T...T...........T...T.......T...T.......T.......T...T.......T...T.......T
T...T.......T...........T...T...T...T...........T...T.......T...T.......T.......T...T.......T...T.......T
T...T...T...TTTTTTTTT...T...TTTTT...TTTTTTTTTTTTT...T...TTTTT...T...T...T...TTTTT...T...TTTTT...TTTTT...T
T.......T...............T.......T...T...................T...T.......T...T...........T...T.......T...T...T
T.......T...............T.......T...T...................T...T.......T...T...........T...T.......T...T...T
T.......T...............T.......T...T...................T...T.......T...T...........T...T.......T...T...T
T...TTTTTTTTTTTTT...TTTTTTTTT...T...T...TTTTTTTTTTTTTTTTT...TTTTTTTTT...TTTTTTTTT...T...T...TTTTT...T...T
T...T...........T...T.......T...T...T...................T.......T.......T.......T...T...T.......T...T...T
T...T...........T...T.......T...T...T...................T.......T.......T.......T...T...T.......T...T...T
T...T...TTTTT...T...T...T...T...T...TTTTTTTTTTTTTTTTT...TTTTT...T...TTTTT...T...TTTTT...TTTTT...T...T...T
T.......T.......T.......T...........T...........................T...........T...................T.......T
T.......T.......T.......T...........T...........................T...........T...................T.......T
T.......T.......T.......T...........T...........................T...........T...................T.......T
TTTTTTTTTTTTTTTTTTTTTTTTTTTTTTTTTTTTTTTTTTTTTTTTTTTTTTTTTTTTTTTTTTTTTTTTTTTTTTTTTTTTTTTTTTTTTTTTTTTTTTTTT